//MAP CONVERTED BY dmm2tgm.py THIS HEADER COMMENT PREVENTS RECONVERSION, DO NOT REMOVE
"a" = (
/area/f13/wasteland)
"f" = (
/turf/open/liquid/water,
/area/f13/wasteland)
"g" = (
/turf/open/indestructible/ground/inside/mountain,
/area/f13/wasteland)
"h" = (
/turf/open/indestructible/ground/outside/desert,
/area/f13/wasteland)
"n" = (
/turf/open/indestructible/ground/outside/civ/drygrass,
/area/f13/wasteland)
"q" = (
/obj/effect/landmark/start/f13/wastelander/den,
/turf/open/indestructible/ground/outside/civ/grass,
/area/f13/wasteland)
"s" = (
/obj/effect/landmark/start/f13/texasranger,
/turf/open/indestructible/ground/outside/civ/grass,
/area/f13/wasteland)
"u" = (
/obj/effect/landmark/start/f13/wastelander/clubmanager,
/turf/open/indestructible/ground/outside/civ/grass,
/area/f13/wasteland)
"v" = (
/obj/effect/landmark/start/f13/wastelander,
/turf/open/indestructible/ground/outside/civ/grass,
/area/f13/wasteland)
"x" = (
/turf/open/indestructible/ground/outside/gravel,
/area/f13/wasteland)
"z" = (
/turf/open/indestructible/ground/outside/civ/grass,
/area/f13/wasteland)
"C" = (
/turf/open/indestructible/ground/outside/dirt,
/area/f13/wasteland)
"F" = (
/obj/effect/landmark/start/f13/wastelander/clubworker,
/turf/open/indestructible/ground/outside/civ/grass,
/area/f13/wasteland)
"J" = (
/turf/open/transparent/openspace,
/area/f13/wasteland)
"L" = (
/obj/structure/ladder/unbreakable{
	height = 1;
	id = "bl"
	},
/turf/open/indestructible/ground/outside/civ/grass,
/area/f13/wasteland)
"Q" = (
/obj/effect/landmark/start/f13/wastelander/gar,
/turf/open/indestructible/ground/outside/civ/grass,
/area/f13/wasteland)
"T" = (
/obj/structure/ladder/unbreakable{
	height = 2;
	id = "bl"
	},
/turf/open/floor/plating/f13/outside/desert,
/area/f13/wasteland)
"U" = (
/obj/structure/stairs/north,
/turf/open/indestructible/ground/outside/civ/grass,
/area/f13/wasteland)
"Z" = (
/turf/open/floor/plating/f13/outside/desert,
/area/f13/wasteland)

(1,1,1) = {"
z
z
z
z
z
z
z
z
z
z
z
z
z
z
z
z
z
z
z
z
z
z
z
z
z
z
z
z
z
z
z
z
z
z
z
z
z
z
z
z
z
z
z
z
z
z
z
z
z
a
"}
(2,1,1) = {"
z
z
z
z
z
z
z
z
z
z
z
z
z
z
z
z
z
z
z
z
z
z
z
z
z
z
z
z
z
z
z
z
z
z
z
z
z
z
z
z
z
z
z
z
z
z
z
z
z
a
"}
(3,1,1) = {"
z
z
z
z
z
z
z
z
z
z
z
z
z
z
z
z
z
z
z
z
z
z
z
z
z
z
z
z
z
z
z
z
z
z
z
z
z
z
z
z
z
z
z
z
z
z
z
z
z
a
"}
(4,1,1) = {"
z
z
z
z
z
z
z
z
z
z
z
z
z
z
z
z
z
z
z
z
z
z
z
z
z
z
z
z
z
z
z
z
z
z
z
z
z
z
z
z
z
z
z
z
z
z
z
z
z
a
"}
(5,1,1) = {"
z
z
z
z
z
z
z
z
z
z
z
z
z
z
z
z
z
h
h
h
h
h
z
z
z
z
z
z
z
z
z
z
z
z
z
z
z
z
z
z
z
z
z
z
z
z
z
z
z
a
"}
(6,1,1) = {"
z
z
z
z
z
z
z
z
z
z
z
z
z
z
z
z
h
h
h
h
h
h
h
z
z
z
z
z
z
z
z
z
z
z
z
z
z
z
z
z
z
z
z
z
z
z
z
z
z
a
"}
(7,1,1) = {"
z
z
z
z
z
z
z
z
z
z
z
z
h
h
h
h
h
h
h
h
h
h
h
z
z
z
z
z
z
z
z
z
z
z
z
z
z
z
z
z
z
z
z
z
z
z
z
z
z
a
"}
(8,1,1) = {"
z
z
z
z
z
z
z
z
z
z
z
h
h
h
h
h
h
h
h
h
h
h
h
z
z
z
z
z
z
g
g
g
n
z
n
z
z
z
z
z
z
z
z
z
z
z
z
z
z
a
"}
(9,1,1) = {"
z
z
z
z
z
z
z
z
z
z
h
h
h
h
h
h
h
h
h
h
h
h
z
z
z
z
z
z
g
g
g
n
n
n
n
z
z
z
z
z
z
z
z
z
z
z
z
z
z
a
"}
(10,1,1) = {"
z
z
z
z
z
z
z
z
z
z
h
h
h
h
f
f
h
h
h
h
h
z
z
z
z
z
z
g
g
g
g
g
n
n
n
z
z
z
z
z
z
z
z
z
z
z
z
z
z
a
"}
(11,1,1) = {"
z
z
z
z
z
z
z
z
z
z
h
h
h
h
f
f
f
h
h
h
z
z
z
z
z
z
g
g
g
f
g
g
g
C
C
n
z
z
z
z
z
n
n
n
z
z
z
z
z
a
"}
(12,1,1) = {"
z
z
z
z
z
z
z
z
z
z
h
h
h
h
f
f
f
h
h
h
z
z
z
z
z
g
g
g
f
f
f
g
g
C
C
n
z
z
z
z
n
n
n
n
z
z
z
z
z
a
"}
(13,1,1) = {"
z
z
z
z
z
z
z
z
z
z
z
h
h
h
h
f
h
h
h
h
h
z
z
z
z
C
C
g
g
f
f
f
g
g
C
C
z
z
z
z
n
n
n
n
z
z
z
z
z
a
"}
(14,1,1) = {"
z
z
z
z
z
z
z
z
z
z
z
h
h
h
h
f
h
h
h
h
z
z
z
g
x
C
C
C
g
g
f
g
g
g
C
C
z
z
z
n
n
n
n
n
z
z
z
z
z
a
"}
(15,1,1) = {"
z
z
z
z
z
z
z
z
z
z
z
z
h
h
h
h
h
h
h
h
z
z
z
g
x
x
x
C
C
g
g
g
g
g
g
z
z
z
z
n
n
n
n
n
z
z
z
z
z
a
"}
(16,1,1) = {"
z
z
z
z
z
z
z
z
z
z
z
z
h
h
h
h
h
h
h
z
z
z
z
z
g
g
x
x
C
C
g
g
z
z
g
z
z
z
n
n
n
n
n
z
z
z
z
z
z
a
"}
(17,1,1) = {"
z
z
z
z
z
z
z
z
z
z
z
z
z
h
h
h
h
h
z
z
z
U
z
z
z
g
g
C
x
x
z
g
z
q
z
z
z
z
n
n
n
n
n
z
z
z
z
z
z
a
"}
(18,1,1) = {"
z
z
z
z
z
z
z
z
z
z
z
z
z
h
h
h
h
h
z
z
z
z
z
z
z
z
z
C
C
x
z
z
z
z
q
z
z
z
n
n
n
n
n
z
z
z
z
z
z
a
"}
(19,1,1) = {"
z
z
z
z
z
z
z
z
z
z
z
z
z
z
z
h
h
h
z
z
z
z
z
U
z
z
C
C
C
x
x
z
z
z
z
q
q
z
n
n
n
n
z
z
z
z
z
z
z
a
"}
(20,1,1) = {"
z
z
z
z
z
z
z
z
z
z
z
z
z
z
z
z
z
z
z
z
z
z
z
z
z
z
C
f
f
C
x
z
z
z
z
z
z
q
z
n
n
z
z
z
z
z
z
z
z
a
"}
(21,1,1) = {"
z
z
z
z
z
z
z
z
z
z
z
z
z
z
z
z
z
z
z
z
z
z
z
z
z
z
C
f
f
C
x
x
z
z
z
z
z
q
z
z
z
z
z
z
z
z
z
z
z
a
"}
(22,1,1) = {"
z
z
z
z
z
z
z
z
z
z
z
z
z
z
z
z
z
z
z
z
z
z
z
z
z
C
C
f
f
f
C
x
x
x
x
x
x
z
z
z
z
z
z
z
z
z
z
z
z
a
"}
(23,1,1) = {"
z
z
z
z
z
z
z
z
z
z
z
z
z
z
z
z
z
z
z
z
z
z
z
z
z
C
C
f
f
C
C
C
n
n
z
z
z
x
x
x
z
z
z
z
z
z
z
z
z
a
"}
(24,1,1) = {"
z
z
z
z
z
z
z
z
z
z
z
z
z
z
z
z
z
z
z
z
z
z
z
z
z
C
C
C
C
C
z
C
C
n
n
z
z
z
z
x
x
x
z
z
z
z
z
z
z
a
"}
(25,1,1) = {"
z
z
z
z
z
z
z
z
z
z
z
z
z
z
z
z
z
z
z
z
z
z
z
z
z
z
C
C
C
z
z
z
C
C
n
n
n
z
z
z
z
x
x
x
x
x
z
z
z
a
"}
(26,1,1) = {"
z
z
z
z
z
z
z
z
z
z
z
z
z
z
v
z
z
z
z
z
z
z
z
z
z
v
z
z
z
z
z
z
z
n
n
n
n
n
n
n
z
z
z
z
x
x
z
z
z
a
"}
(27,1,1) = {"
z
z
z
z
z
z
z
z
z
z
z
z
z
z
v
z
z
z
z
z
z
z
z
z
z
z
z
z
z
z
z
z
z
z
z
z
n
f
f
n
z
z
z
z
x
x
z
z
z
a
"}
(28,1,1) = {"
z
z
z
z
z
z
z
z
z
z
z
z
z
z
v
z
z
z
z
z
z
z
z
z
z
z
z
z
z
z
z
z
z
z
z
z
z
n
n
n
z
z
z
z
z
x
z
z
z
a
"}
(29,1,1) = {"
z
z
z
z
z
z
z
z
z
z
z
z
z
z
v
z
z
z
z
z
z
z
z
z
z
z
z
z
z
z
z
z
z
z
z
z
z
z
z
n
z
z
z
z
z
x
z
z
z
a
"}
(30,1,1) = {"
z
z
z
z
z
z
z
z
z
z
z
z
z
z
v
z
z
z
z
z
z
z
z
z
z
z
z
z
z
z
z
z
z
z
z
z
z
z
z
z
z
z
z
z
z
x
z
z
z
a
"}
(31,1,1) = {"
z
z
z
z
z
z
z
z
z
z
z
z
z
z
z
z
z
z
z
z
z
z
z
z
z
z
z
z
z
z
z
z
z
z
z
z
z
z
z
z
z
z
z
z
z
x
z
z
z
a
"}
(32,1,1) = {"
z
z
z
z
z
z
z
z
z
z
z
z
z
z
z
z
z
z
z
z
z
z
z
z
z
z
z
z
z
z
z
z
z
z
z
z
z
z
z
z
z
z
z
z
x
x
x
z
z
a
"}
(33,1,1) = {"
z
z
z
z
z
z
z
z
z
z
z
z
z
z
z
z
z
z
z
z
z
z
z
z
z
z
z
z
z
z
z
z
z
z
z
z
z
z
z
z
z
z
z
x
x
f
f
x
z
a
"}
(34,1,1) = {"
z
z
z
z
z
z
z
z
z
z
z
z
z
z
v
z
z
z
z
z
z
z
z
z
z
z
z
z
z
z
z
z
z
z
z
z
z
z
z
z
z
n
n
x
f
f
f
x
z
a
"}
(35,1,1) = {"
z
z
z
z
z
z
z
z
z
z
z
z
z
z
z
z
z
z
z
z
z
z
z
z
z
z
z
z
z
z
z
z
z
z
z
z
Q
z
z
z
z
n
x
x
f
f
f
f
z
a
"}
(36,1,1) = {"
z
z
z
z
z
z
z
z
z
z
z
z
z
z
z
z
z
z
z
z
z
z
z
z
z
z
z
z
z
z
z
z
z
z
z
z
Q
z
z
z
z
z
n
x
f
f
f
f
z
a
"}
(37,1,1) = {"
z
z
z
z
z
z
z
z
z
z
z
z
z
z
z
z
z
z
z
z
z
z
z
z
z
z
z
z
z
z
z
z
z
z
z
z
z
Q
z
z
z
z
z
z
x
x
x
x
z
a
"}
(38,1,1) = {"
z
z
z
z
z
z
z
z
z
z
z
z
z
v
z
z
z
z
z
z
z
z
z
z
z
z
z
z
z
z
z
z
z
z
z
z
z
z
z
z
z
z
z
z
z
x
z
z
z
a
"}
(39,1,1) = {"
z
z
z
z
z
z
z
z
z
z
z
z
z
z
z
z
z
z
z
z
z
z
z
z
z
z
z
z
z
z
z
z
z
z
z
z
z
z
Q
z
z
z
z
z
z
z
z
z
z
a
"}
(40,1,1) = {"
z
z
z
z
z
z
z
z
z
z
z
z
z
z
z
z
z
z
z
z
z
z
z
z
z
z
z
z
z
z
z
z
z
z
z
z
z
z
z
z
z
z
z
z
z
z
z
z
z
a
"}
(41,1,1) = {"
z
z
z
z
z
z
z
z
z
z
z
z
z
v
z
z
z
z
z
z
z
z
z
z
z
z
z
z
z
z
z
z
z
z
z
z
z
z
z
Q
z
z
z
z
z
z
z
z
z
a
"}
(42,1,1) = {"
z
z
z
z
z
z
z
z
z
z
z
z
v
z
z
z
z
z
z
z
z
z
z
z
z
z
z
z
z
z
z
z
z
z
z
z
z
z
z
z
z
z
z
z
z
z
z
z
z
a
"}
(43,1,1) = {"
z
z
z
z
z
z
z
z
z
z
z
z
v
z
z
z
z
z
z
z
z
z
z
z
z
z
z
z
z
z
z
z
z
z
z
z
z
z
z
z
Q
z
z
z
z
z
z
z
z
a
"}
(44,1,1) = {"
z
z
z
z
z
z
z
z
z
z
z
z
v
z
z
z
z
z
z
z
z
z
z
z
z
z
z
z
z
z
z
z
z
z
z
z
z
z
z
z
Q
z
z
z
z
z
z
z
z
a
"}
(45,1,1) = {"
z
z
z
z
z
z
z
z
z
z
z
z
z
z
z
z
z
z
z
z
z
z
z
z
z
z
z
z
z
z
z
z
z
z
z
z
z
z
z
z
z
z
z
z
z
z
z
z
z
a
"}
(46,1,1) = {"
z
z
z
z
z
z
z
z
z
z
z
z
z
z
z
z
z
z
z
z
z
z
z
z
z
z
z
z
z
z
z
z
z
z
z
z
z
z
z
z
z
z
z
z
z
z
z
z
z
a
"}
(47,1,1) = {"
z
z
z
z
z
z
z
z
z
z
z
z
z
z
z
z
z
z
z
z
z
z
z
z
z
z
z
z
z
z
z
z
z
z
z
z
z
z
z
z
z
z
z
z
z
z
z
z
z
a
"}
(48,1,1) = {"
z
z
z
z
z
z
z
z
z
z
z
z
z
z
z
z
z
z
z
z
z
z
z
z
z
z
z
z
z
z
z
z
z
z
z
z
z
z
z
z
z
z
z
z
z
z
z
z
z
a
"}
(49,1,1) = {"
z
z
z
z
z
z
z
z
z
z
z
z
z
z
z
z
z
z
z
z
z
z
z
z
z
z
z
z
z
z
z
z
z
z
z
z
z
z
z
z
z
z
z
z
z
z
z
z
z
a
"}
(50,1,1) = {"
z
z
z
z
z
z
z
z
z
z
z
z
z
z
z
z
z
z
z
z
z
z
z
z
z
z
z
z
z
z
z
z
z
z
z
z
z
z
z
z
z
z
z
z
z
z
z
z
z
a
"}

(1,1,2) = {"
J
J
J
J
J
J
J
J
J
J
J
J
J
J
J
J
J
J
J
J
J
J
J
J
J
J
J
J
J
J
J
J
J
J
J
J
J
J
J
J
J
J
J
J
J
J
J
J
J
J
"}
(2,1,2) = {"
J
J
J
J
J
J
J
J
J
J
J
J
J
J
J
J
J
J
J
J
J
J
J
J
J
J
J
J
J
J
J
J
J
J
J
J
J
J
J
J
J
J
J
J
J
J
J
J
J
J
"}
(3,1,2) = {"
J
J
J
J
J
J
J
J
J
J
J
J
J
J
J
J
J
J
J
J
J
J
J
J
J
J
J
J
J
J
J
J
J
J
J
J
J
J
J
J
J
J
J
J
J
J
J
J
J
J
"}
(4,1,2) = {"
J
J
J
J
J
J
J
J
J
J
J
J
J
J
J
J
J
J
J
J
J
J
J
J
J
J
J
J
J
J
J
J
J
J
J
J
J
J
J
J
J
J
J
J
J
J
J
J
J
J
"}
(5,1,2) = {"
J
J
J
J
J
J
J
J
J
J
J
J
J
J
J
J
J
J
J
J
J
J
J
J
J
J
J
J
J
J
J
J
J
J
J
J
J
J
J
J
J
J
J
J
J
J
J
J
J
J
"}
(6,1,2) = {"
J
J
J
J
J
J
J
J
J
J
J
J
J
J
J
J
J
J
J
J
J
J
J
J
J
J
J
J
J
J
J
J
J
J
J
J
J
J
J
J
J
J
J
J
J
J
J
J
J
J
"}
(7,1,2) = {"
J
J
J
J
J
J
J
J
J
J
J
J
J
J
J
J
J
J
J
J
J
J
J
J
J
J
J
J
J
J
J
J
J
J
J
J
J
J
J
J
J
J
J
J
J
J
J
J
J
J
"}
(8,1,2) = {"
J
J
J
J
J
J
J
J
J
J
J
J
J
J
J
J
J
J
J
J
J
J
J
J
J
J
J
J
J
J
J
J
J
J
J
J
J
J
J
J
J
J
J
J
J
J
J
J
J
J
"}
(9,1,2) = {"
J
J
J
J
J
J
J
J
J
J
J
J
J
J
J
J
J
J
J
J
J
J
J
J
J
J
J
J
J
J
J
J
J
J
J
J
J
J
J
J
J
J
J
J
J
J
J
J
J
J
"}
(10,1,2) = {"
J
J
J
J
J
J
J
J
J
J
J
J
J
J
J
J
J
J
J
J
J
J
J
J
J
J
J
J
J
J
J
J
J
J
J
J
J
J
J
J
J
J
J
J
J
J
J
J
J
J
"}
(11,1,2) = {"
J
J
J
J
J
J
J
J
J
J
J
J
J
J
J
J
J
J
J
J
J
J
J
J
J
J
J
J
J
J
J
J
J
J
J
J
J
J
J
J
J
J
J
J
J
J
J
J
J
J
"}
(12,1,2) = {"
J
J
J
J
J
J
J
J
J
J
J
J
J
J
J
J
J
J
J
J
J
J
J
J
J
J
J
J
J
J
J
J
J
J
J
J
J
J
J
J
J
J
J
J
J
J
J
J
J
J
"}
(13,1,2) = {"
J
J
J
J
J
J
J
J
J
J
J
J
J
J
J
J
J
J
J
J
J
J
J
J
J
J
J
J
J
J
J
J
J
J
J
J
J
J
J
J
J
J
J
J
J
J
J
J
J
J
"}
(14,1,2) = {"
J
J
J
J
J
J
J
J
J
J
J
J
J
J
J
J
J
J
J
J
J
J
J
J
J
J
J
J
J
J
J
J
J
J
J
J
J
J
J
J
J
J
J
J
J
J
J
J
J
J
"}
(15,1,2) = {"
J
J
J
J
J
J
J
J
J
J
J
J
J
J
J
C
J
J
J
J
J
J
J
J
J
J
J
J
J
J
J
J
J
J
J
J
J
J
J
J
J
J
J
J
J
J
J
J
J
J
"}
(16,1,2) = {"
J
J
J
J
J
J
J
J
J
J
J
J
C
C
C
C
C
J
J
a
a
J
J
J
J
J
J
J
J
J
J
J
J
J
J
J
J
J
J
J
J
J
J
J
J
J
J
J
J
J
"}
(17,1,2) = {"
J
J
J
J
J
J
J
J
J
z
z
z
C
C
C
C
C
C
z
z
z
J
J
J
J
J
J
J
J
J
J
J
J
J
J
J
J
J
J
J
J
J
J
J
J
J
J
J
J
J
"}
(18,1,2) = {"
J
J
J
J
J
J
J
J
J
z
z
z
z
z
z
z
z
z
z
z
z
a
a
J
J
J
J
J
J
J
J
J
J
J
J
J
J
J
J
J
J
J
J
J
J
J
J
J
J
J
"}
(19,1,2) = {"
J
J
J
J
J
J
J
J
J
z
z
z
z
z
s
s
s
z
z
z
z
z
z
J
J
J
J
J
J
J
J
J
J
J
J
J
J
J
J
J
J
J
J
J
J
J
J
J
J
J
"}
(20,1,2) = {"
J
J
J
J
J
J
J
J
J
z
z
z
z
z
s
s
s
z
z
u
u
u
z
J
J
J
J
J
J
J
J
J
J
J
J
J
J
J
J
J
J
J
J
J
J
J
J
J
J
J
"}
(21,1,2) = {"
J
J
J
J
J
J
J
J
z
z
z
z
z
z
s
s
s
z
z
u
u
u
z
J
J
J
J
J
J
J
J
J
J
J
J
J
J
J
J
J
J
J
J
J
J
J
J
J
J
J
"}
(22,1,2) = {"
J
J
J
J
J
J
J
J
z
z
z
z
z
z
z
z
z
z
z
z
z
z
z
J
J
J
J
J
J
J
J
J
J
J
J
J
J
J
J
J
J
J
J
J
J
J
J
J
J
J
"}
(23,1,2) = {"
J
J
J
J
J
J
J
z
z
z
z
z
L
z
U
z
F
F
F
z
C
C
z
z
z
J
J
J
J
J
J
J
J
J
J
J
J
J
J
J
J
J
J
J
J
J
J
J
J
J
"}
(24,1,2) = {"
J
J
J
J
J
J
J
z
z
z
z
z
z
z
z
z
F
F
F
C
C
C
z
z
z
J
J
J
J
J
J
J
J
J
J
J
J
J
J
J
J
J
J
J
J
J
J
J
J
J
"}
(25,1,2) = {"
J
J
J
J
J
J
J
z
z
z
z
z
z
z
z
z
F
F
F
C
C
C
C
z
z
J
J
J
J
J
J
J
J
J
J
J
J
J
J
J
J
J
J
J
J
J
J
J
J
J
"}
(26,1,2) = {"
J
J
J
J
J
J
J
z
z
z
z
z
z
z
z
z
z
z
z
z
z
C
C
z
z
J
J
J
J
J
J
J
J
J
J
J
J
J
J
J
J
J
J
J
J
J
J
J
J
J
"}
(27,1,2) = {"
J
J
J
J
J
J
J
J
z
z
z
z
z
z
z
z
z
z
z
z
z
z
C
z
z
J
J
J
J
J
J
J
J
J
J
J
J
J
J
J
J
J
J
J
J
J
J
J
J
J
"}
(28,1,2) = {"
J
J
J
J
J
J
J
J
J
z
z
z
z
z
z
z
z
z
z
g
z
z
z
z
z
J
J
J
J
J
J
J
J
J
J
J
J
J
J
J
J
J
J
J
J
J
J
J
J
J
"}
(29,1,2) = {"
J
J
J
J
J
J
J
J
J
z
z
z
z
z
z
z
z
z
g
g
g
z
z
z
z
J
J
J
J
J
J
J
J
J
J
J
J
J
J
J
J
J
J
J
J
J
J
J
J
J
"}
(30,1,2) = {"
J
J
J
J
J
J
J
J
J
z
z
z
z
z
z
z
z
g
g
g
g
g
z
z
z
J
J
J
J
J
J
J
J
J
J
J
J
J
J
J
J
J
J
J
J
J
J
J
J
J
"}
(31,1,2) = {"
J
J
J
J
J
J
J
J
J
J
J
J
J
J
J
J
g
g
g
g
g
g
J
J
J
J
J
J
J
J
J
J
J
J
J
J
J
J
J
J
J
J
J
J
J
J
J
J
J
J
"}
(32,1,2) = {"
J
J
J
J
J
J
J
J
J
J
J
J
J
J
J
J
g
g
g
g
J
J
J
J
J
J
J
J
J
J
J
J
J
J
J
J
J
J
J
J
J
J
J
J
J
J
J
J
J
J
"}
(33,1,2) = {"
J
J
J
J
J
J
J
J
J
J
J
J
J
J
J
J
J
J
J
J
J
J
J
J
J
J
J
J
J
J
J
J
J
J
J
J
J
J
J
J
J
J
J
J
J
J
J
J
J
J
"}
(34,1,2) = {"
J
J
J
J
J
J
J
J
J
J
J
J
J
J
J
J
J
J
J
J
J
J
J
J
J
J
J
J
J
J
J
J
J
J
J
J
J
J
J
J
J
J
J
J
J
J
J
J
J
J
"}
(35,1,2) = {"
J
J
J
J
J
J
J
J
J
J
J
J
J
J
J
J
J
J
J
J
J
J
J
J
J
J
J
J
J
J
J
J
J
J
J
J
J
J
J
J
J
J
J
J
J
J
J
J
J
J
"}
(36,1,2) = {"
J
J
J
J
J
J
J
J
J
J
J
J
J
J
J
J
J
J
J
J
J
J
J
J
J
J
J
J
J
J
J
J
J
J
J
J
J
J
J
J
J
J
J
J
J
J
J
J
J
J
"}
(37,1,2) = {"
J
J
J
J
J
J
J
J
J
J
J
J
J
J
J
J
J
J
J
J
J
J
J
J
J
J
J
J
J
J
J
J
J
J
J
J
J
J
J
J
J
J
J
J
J
J
J
J
J
J
"}
(38,1,2) = {"
J
J
J
J
J
J
J
J
J
J
J
J
J
J
J
J
J
J
J
J
J
J
J
J
J
J
J
J
J
J
J
J
J
J
J
J
J
J
J
J
J
J
J
J
J
J
J
J
J
J
"}
(39,1,2) = {"
J
J
J
J
J
J
J
J
J
J
J
J
J
J
J
J
J
J
J
J
J
J
J
J
J
J
J
J
J
J
J
J
J
J
J
J
J
J
J
J
J
J
J
J
J
J
J
J
J
J
"}
(40,1,2) = {"
J
J
J
J
J
J
J
J
J
J
J
J
J
J
J
J
J
J
J
J
J
J
J
J
J
J
J
J
J
J
J
J
J
J
J
J
J
J
J
J
J
J
J
J
J
J
J
J
J
J
"}
(41,1,2) = {"
J
J
J
J
J
J
J
J
J
J
J
J
J
J
J
J
J
J
J
J
J
J
J
J
J
J
J
J
J
J
J
J
J
J
J
J
J
J
J
J
J
J
J
J
J
J
J
J
J
J
"}
(42,1,2) = {"
J
J
J
J
J
J
J
J
J
J
J
J
J
J
J
J
J
J
J
J
J
J
J
J
J
J
J
J
J
J
J
J
J
J
J
J
J
J
J
J
J
J
J
J
J
J
J
J
J
J
"}
(43,1,2) = {"
J
J
J
J
J
J
J
J
J
J
J
J
J
J
J
J
J
J
J
J
J
J
J
J
J
J
J
J
J
J
J
J
J
J
J
J
J
J
J
J
J
J
J
J
J
J
J
J
J
J
"}
(44,1,2) = {"
J
J
J
J
J
J
J
J
J
J
J
J
J
J
J
J
J
J
J
J
J
J
J
J
J
J
J
J
J
J
J
J
J
J
J
J
J
J
J
J
J
J
J
J
J
J
J
J
J
J
"}
(45,1,2) = {"
J
J
J
J
J
J
J
J
J
J
J
J
J
J
J
J
J
J
J
J
J
J
J
J
J
J
J
J
J
J
J
J
J
J
J
J
J
J
J
J
J
J
J
J
J
J
J
J
J
J
"}
(46,1,2) = {"
J
J
J
J
J
J
J
J
J
J
J
J
J
J
J
J
J
J
J
J
J
J
J
J
J
J
J
J
J
J
J
J
J
J
J
J
J
J
J
J
J
J
J
J
J
J
J
J
J
J
"}
(47,1,2) = {"
J
J
J
J
J
J
J
J
J
J
J
J
J
J
J
J
J
J
J
J
J
J
J
J
J
J
J
J
J
J
J
J
J
J
J
J
J
J
J
J
J
J
J
J
J
J
J
J
J
J
"}
(48,1,2) = {"
J
J
J
J
J
J
J
J
J
J
J
J
J
J
J
J
J
J
J
J
J
J
J
J
J
J
J
J
J
J
J
J
J
J
J
J
J
J
J
J
J
J
J
J
J
J
J
J
J
J
"}
(49,1,2) = {"
J
J
J
J
J
J
J
J
J
J
J
J
J
J
J
J
J
J
J
J
J
J
J
J
J
J
J
J
J
J
J
J
J
J
J
J
J
J
J
J
J
J
J
J
J
J
J
J
J
J
"}
(50,1,2) = {"
J
J
J
J
J
J
J
J
J
J
J
J
J
J
J
J
J
J
J
J
J
J
J
J
J
J
J
J
J
J
J
J
J
J
J
J
J
J
J
J
J
J
J
J
J
J
J
J
J
J
"}

(1,1,3) = {"
J
J
J
J
J
J
J
J
J
J
J
J
J
J
J
J
J
J
J
J
J
J
J
J
J
J
J
J
J
J
J
J
J
J
J
J
J
J
J
J
J
J
J
J
J
J
J
J
J
J
"}
(2,1,3) = {"
J
J
J
J
J
J
J
J
J
J
J
J
J
J
J
J
J
J
J
J
J
J
J
J
J
J
J
J
J
J
J
J
J
J
J
J
J
J
J
J
J
J
J
J
J
J
J
J
J
J
"}
(3,1,3) = {"
J
J
J
J
J
J
J
J
J
J
J
J
J
J
J
J
J
J
J
J
J
J
J
J
J
J
J
J
J
J
J
J
J
J
J
J
J
J
J
J
J
J
J
J
J
J
J
J
J
J
"}
(4,1,3) = {"
J
J
J
J
J
J
J
J
J
J
J
J
J
J
J
J
J
J
J
J
J
J
J
J
J
J
J
J
J
J
J
J
J
J
J
J
J
J
J
J
J
J
J
J
J
J
J
J
J
J
"}
(5,1,3) = {"
J
J
J
J
J
J
J
J
J
J
J
J
J
J
J
J
J
J
J
J
J
J
J
J
J
J
J
J
J
J
J
J
J
J
J
J
J
J
J
J
J
J
J
J
J
J
J
J
J
J
"}
(6,1,3) = {"
J
J
J
J
J
J
J
J
J
J
J
J
J
J
J
J
J
J
J
J
J
J
J
J
J
J
J
J
J
J
J
J
J
J
J
J
J
J
J
J
J
J
J
J
J
J
J
J
J
J
"}
(7,1,3) = {"
J
J
J
J
J
J
J
J
J
J
J
J
J
J
J
J
J
J
J
J
J
J
J
J
J
J
J
J
J
J
J
J
J
J
J
J
J
J
J
J
J
J
J
J
J
J
J
J
J
J
"}
(8,1,3) = {"
J
J
J
J
J
J
J
J
J
J
J
J
J
J
J
J
J
J
J
J
J
J
J
J
J
J
J
J
J
J
J
J
J
J
J
J
J
J
J
J
J
J
J
J
J
J
J
J
J
J
"}
(9,1,3) = {"
J
J
J
J
J
J
J
J
J
J
J
J
J
J
J
J
J
J
J
J
J
J
J
J
J
J
J
J
J
J
J
J
J
J
J
J
J
J
J
J
J
J
J
J
J
J
J
J
J
J
"}
(10,1,3) = {"
J
J
J
J
J
J
J
J
J
J
J
J
J
J
J
J
J
J
J
J
J
J
J
J
J
J
J
J
J
J
J
J
J
J
J
J
J
J
J
J
J
J
J
J
J
J
J
J
J
J
"}
(11,1,3) = {"
J
J
J
J
J
J
J
J
J
J
J
J
J
J
J
J
J
J
J
J
J
J
J
J
J
J
J
J
J
J
J
J
J
J
J
J
J
J
J
J
J
J
J
J
J
J
J
J
J
J
"}
(12,1,3) = {"
J
J
J
J
J
J
J
J
J
J
J
J
J
J
J
J
J
J
J
J
J
J
J
J
J
J
J
J
J
J
J
J
J
J
J
J
J
J
J
J
J
J
J
J
J
J
J
J
J
J
"}
(13,1,3) = {"
J
J
J
J
J
J
J
J
J
J
J
J
J
J
J
J
J
J
J
J
J
J
J
J
J
J
J
J
J
J
J
J
J
J
J
J
J
J
J
J
J
J
J
J
J
J
J
J
J
J
"}
(14,1,3) = {"
J
J
J
J
J
J
J
J
J
J
J
J
J
J
J
J
J
J
J
J
J
J
J
J
J
J
J
J
J
J
J
J
J
J
J
J
J
J
J
J
J
J
J
J
J
J
J
J
J
J
"}
(15,1,3) = {"
J
J
J
J
J
J
J
J
J
J
J
J
J
J
J
J
J
J
J
J
J
J
J
J
J
J
J
J
J
J
J
J
J
J
J
J
J
J
J
J
J
J
J
J
J
J
J
J
J
J
"}
(16,1,3) = {"
J
J
J
J
J
J
J
J
J
J
J
J
J
J
J
J
J
J
J
J
J
J
J
J
J
J
J
J
J
J
J
J
J
J
J
J
J
J
J
J
J
J
J
J
J
J
J
J
J
J
"}
(17,1,3) = {"
J
J
J
J
J
J
J
J
J
J
J
J
J
J
J
J
J
J
J
J
J
J
J
J
J
J
J
J
J
J
J
J
J
J
J
J
J
J
J
J
J
J
J
J
J
J
J
J
J
J
"}
(18,1,3) = {"
J
J
J
J
J
J
J
J
J
J
J
J
J
J
J
J
J
J
J
J
J
J
J
J
J
J
J
J
J
J
J
J
J
J
J
J
J
J
J
J
J
J
J
J
J
J
J
J
J
J
"}
(19,1,3) = {"
J
J
J
J
J
J
J
J
J
J
J
J
J
J
J
J
J
J
J
J
J
J
J
J
J
J
J
J
J
J
J
J
J
J
J
J
J
J
J
J
J
J
J
J
J
J
J
J
J
J
"}
(20,1,3) = {"
J
J
J
J
J
J
J
J
J
J
J
J
J
J
J
J
J
J
J
J
J
J
J
J
J
J
J
J
J
J
J
J
J
J
J
J
J
J
J
J
J
J
J
J
J
J
J
J
J
J
"}
(21,1,3) = {"
J
J
J
J
J
J
J
J
J
J
J
J
J
J
J
J
J
J
J
J
J
J
J
J
J
J
J
J
J
J
J
J
J
J
J
J
J
J
J
J
J
J
J
J
J
J
J
J
J
J
"}
(22,1,3) = {"
J
J
J
J
J
J
J
J
J
J
J
Z
Z
Z
J
J
J
J
J
J
J
J
J
J
J
J
J
J
J
J
J
J
J
J
J
J
J
J
J
J
J
J
J
J
J
J
J
J
J
J
"}
(23,1,3) = {"
J
J
J
J
J
J
J
J
J
J
J
Z
T
Z
J
J
J
J
J
J
J
J
J
J
J
J
J
J
J
J
J
J
J
J
J
J
J
J
J
J
J
J
J
J
J
J
J
J
J
J
"}
(24,1,3) = {"
J
J
J
J
J
J
J
J
J
J
J
Z
Z
Z
J
J
J
J
J
J
J
J
J
J
J
J
J
J
J
J
J
J
J
J
J
J
J
J
J
J
J
J
J
J
J
J
J
J
J
J
"}
(25,1,3) = {"
J
J
J
J
J
J
J
J
J
J
J
J
J
J
J
J
J
J
J
J
J
J
J
J
J
J
J
J
J
J
J
J
J
J
J
J
J
J
J
J
J
J
J
J
J
J
J
J
J
J
"}
(26,1,3) = {"
J
J
J
J
J
J
J
J
J
J
J
J
J
J
J
J
J
J
J
J
J
J
J
J
J
J
J
J
J
J
J
J
J
J
J
J
J
J
J
J
J
J
J
J
J
J
J
J
J
J
"}
(27,1,3) = {"
J
J
J
J
J
J
J
J
J
J
J
J
J
J
J
J
J
J
J
J
J
J
J
J
J
J
J
J
J
J
J
J
J
J
J
J
J
J
J
J
J
J
J
J
J
J
J
J
J
J
"}
(28,1,3) = {"
J
J
J
J
J
J
J
J
J
J
J
J
J
J
J
J
J
J
J
J
J
J
J
J
J
J
J
J
J
J
J
J
J
J
J
J
J
J
J
J
J
J
J
J
J
J
J
J
J
J
"}
(29,1,3) = {"
J
J
J
J
J
J
J
J
J
J
J
J
J
J
J
J
J
J
J
J
J
J
J
J
J
J
J
J
J
J
J
J
J
J
J
J
J
J
J
J
J
J
J
J
J
J
J
J
J
J
"}
(30,1,3) = {"
J
J
J
J
J
J
J
J
J
J
J
J
J
J
J
J
J
J
J
J
J
J
J
J
J
J
J
J
J
J
J
J
J
J
J
J
J
J
J
J
J
J
J
J
J
J
J
J
J
J
"}
(31,1,3) = {"
J
J
J
J
J
J
J
J
J
J
J
J
J
J
J
J
J
J
J
J
J
J
J
J
J
J
J
J
J
J
J
J
J
J
J
J
J
J
J
J
J
J
J
J
J
J
J
J
J
J
"}
(32,1,3) = {"
J
J
J
J
J
J
J
J
J
J
J
J
J
J
J
J
J
J
J
J
J
J
J
J
J
J
J
J
J
J
J
J
J
J
J
J
J
J
J
J
J
J
J
J
J
J
J
J
J
J
"}
(33,1,3) = {"
J
J
J
J
J
J
J
J
J
J
J
J
J
J
J
J
J
J
J
J
J
J
J
J
J
J
J
J
J
J
J
J
J
J
J
J
J
J
J
J
J
J
J
J
J
J
J
J
J
J
"}
(34,1,3) = {"
J
J
J
J
J
J
J
J
J
J
J
J
J
J
J
J
J
J
J
J
J
J
J
J
J
J
J
J
J
J
J
J
J
J
J
J
J
J
J
J
J
J
J
J
J
J
J
J
J
J
"}
(35,1,3) = {"
J
J
J
J
J
J
J
J
J
J
J
J
J
J
J
J
J
J
J
J
J
J
J
J
J
J
J
J
J
J
J
J
J
J
J
J
J
J
J
J
J
J
J
J
J
J
J
J
J
J
"}
(36,1,3) = {"
J
J
J
J
J
J
J
J
J
J
J
J
J
J
J
J
J
J
J
J
J
J
J
J
J
J
J
J
J
J
J
J
J
J
J
J
J
J
J
J
J
J
J
J
J
J
J
J
J
J
"}
(37,1,3) = {"
J
J
J
J
J
J
J
J
J
J
J
J
J
J
J
J
J
J
J
J
J
J
J
J
J
J
J
J
J
J
J
J
J
J
J
J
J
J
J
J
J
J
J
J
J
J
J
J
J
J
"}
(38,1,3) = {"
J
J
J
J
J
J
J
J
J
J
J
J
J
J
J
J
J
J
J
J
J
J
J
J
J
J
J
J
J
J
J
J
J
J
J
J
J
J
J
J
J
J
J
J
J
J
J
J
J
J
"}
(39,1,3) = {"
J
J
J
J
J
J
J
J
J
J
J
J
J
J
J
J
J
J
J
J
J
J
J
J
J
J
J
J
J
J
J
J
J
J
J
J
J
J
J
J
J
J
J
J
J
J
J
J
J
J
"}
(40,1,3) = {"
J
J
J
J
J
J
J
J
J
J
J
J
J
J
J
J
J
J
J
J
J
J
J
J
J
J
J
J
J
J
J
J
J
J
J
J
J
J
J
J
J
J
J
J
J
J
J
J
J
J
"}
(41,1,3) = {"
J
J
J
J
J
J
J
J
J
J
J
J
J
J
J
J
J
J
J
J
J
J
J
J
J
J
J
J
J
J
J
J
J
J
J
J
J
J
J
J
J
J
J
J
J
J
J
J
J
J
"}
(42,1,3) = {"
J
J
J
J
J
J
J
J
J
J
J
J
J
J
J
J
J
J
J
J
J
J
J
J
J
J
J
J
J
J
J
J
J
J
J
J
J
J
J
J
J
J
J
J
J
J
J
J
J
J
"}
(43,1,3) = {"
J
J
J
J
J
J
J
J
J
J
J
J
J
J
J
J
J
J
J
J
J
J
J
J
J
J
J
J
J
J
J
J
J
J
J
J
J
J
J
J
J
J
J
J
J
J
J
J
J
J
"}
(44,1,3) = {"
J
J
J
J
J
J
J
J
J
J
J
J
J
J
J
J
J
J
J
J
J
J
J
J
J
J
J
J
J
J
J
J
J
J
J
J
J
J
J
J
J
J
J
J
J
J
J
J
J
J
"}
(45,1,3) = {"
J
J
J
J
J
J
J
J
J
J
J
J
J
J
J
J
J
J
J
J
J
J
J
J
J
J
J
J
J
J
J
J
J
J
J
J
J
J
J
J
J
J
J
J
J
J
J
J
J
J
"}
(46,1,3) = {"
J
J
J
J
J
J
J
J
J
J
J
J
J
J
J
J
J
J
J
J
J
J
J
J
J
J
J
J
J
J
J
J
J
J
J
J
J
J
J
J
J
J
J
J
J
J
J
J
J
J
"}
(47,1,3) = {"
J
J
J
J
J
J
J
J
J
J
J
J
J
J
J
J
J
J
J
J
J
J
J
J
J
J
J
J
J
J
J
J
J
J
J
J
J
J
J
J
J
J
J
J
J
J
J
J
J
J
"}
(48,1,3) = {"
J
J
J
J
J
J
J
J
J
J
J
J
J
J
J
J
J
J
J
J
J
J
J
J
J
J
J
J
J
J
J
J
J
J
J
J
J
J
J
J
J
J
J
J
J
J
J
J
J
J
"}
(49,1,3) = {"
J
J
J
J
J
J
J
J
J
J
J
J
J
J
J
J
J
J
J
J
J
J
J
J
J
J
J
J
J
J
J
J
J
J
J
J
J
J
J
J
J
J
J
J
J
J
J
J
J
J
"}
(50,1,3) = {"
J
J
J
J
J
J
J
J
J
J
J
J
J
J
J
J
J
J
J
J
J
J
J
J
J
J
J
J
J
J
J
J
J
J
J
J
J
J
J
J
J
J
J
J
J
J
J
J
J
J
"}
