//MAP CONVERTED BY dmm2tgm.py THIS HEADER COMMENT PREVENTS RECONVERSION, DO NOT REMOVE
"a" = (
/turf/closed/indestructible/opshuttle,
/area/shuttle/supply)
"f" = (
/turf/open/floor/plasteel/floorgrime,
/area/shuttle/supply)
"g" = (
/obj/machinery/shuttle,
/turf/open/transparent/openspace,
/area/shuttle/supply)
"h" = (
/obj/machinery/light{
	dir = 8
	},
/turf/open/floor/plasteel/floorgrime,
/area/shuttle/supply)
"l" = (
/obj/structure/simple_door/bunker,
/turf/open/floor/plasteel/floorgrime,
/area/shuttle/supply)
"o" = (
/turf/open/transparent/openspace,
/area/shuttle/supply)
"w" = (
/obj/docking_port/mobile/supply,
/turf/closed/indestructible/opshuttle,
/area/shuttle/supply)
"y" = (
/obj/machinery/light{
	dir = 4
	},
/turf/open/floor/plasteel/floorgrime,
/area/shuttle/supply)
"J" = (
/obj/machinery/light{
	dir = 1
	},
/turf/open/floor/plasteel/floorgrime,
/area/shuttle/supply)
"W" = (
/obj/machinery/light,
/turf/open/floor/plasteel/floorgrime,
/area/shuttle/supply)

(1,1,1) = {"
g
a
a
l
l
a
l
l
a
a
"}
(2,1,1) = {"
g
a
f
f
f
h
f
f
f
a
"}
(3,1,1) = {"
o
a
J
f
f
f
f
f
f
a
"}
(4,1,1) = {"
o
a
f
f
f
f
f
f
W
a
"}
(5,1,1) = {"
g
a
f
f
f
y
f
f
f
a
"}
(6,1,1) = {"
g
a
a
l
l
w
l
l
a
a
"}
